#####  
#   ## 
# #  ##
#o #@ #
#  A  #
#o##@##
#    # 
###### 