###o   #  ##
     @ #   #
 @  A  o#  #
###@       #
 o    ##   #
      #    #
########  ##