##########
#o###    #
#  ###@# #
#      @ #
#   #    #
#   ###  #
#   #o   #
# @##    #
# A  o   #
##########